00,00,00,00,00,00,00,00,00,00,00,00,00,00,00,00,00,00,00,00
00,00,00,00,00,00,00,00,00,00,00,00,00,00,00,00,00,00,00,00
00,00,00,00,00,00,00,00,00,00,00,00,00,00,00,00,00,00,00,00
00,00,00,00,00,00,00,00,00,00,00,00,00,00,00,00,00,00,00,00
00,00,00,00,00,00,00,11,12,12,12,12,13,00,00,00,00,00,00,00
00,00,00,00,00,00,00,14,21,22,23,22,04,00,00,00,00,00,00,00
00,00,00,00,00,00,00,14,21,24,25,22,16,00,00,00,00,00,00,00
00,00,00,00,00,00,00,14,22,23,24,22,16,00,00,00,00,00,00,00
00,00,00,00,00,00,00,03,22,22,23,21,16,00,00,00,00,00,00,00
00,00,00,00,00,00,00,17,18,18,18,18,19,00,00,00,00,00,00,00
00,00,00,00,00,00,00,00,00,00,00,00,00,00,00,00,00,00,00,00
00,00,00,00,00,00,00,00,00,00,00,00,00,00,00,00,00,00,00,00
00,00,00,00,00,00,00,00,00,00,00,00,00,00,00,00,00,00,00,00
00,00,00,00,00,00,00,00,00,00,00,00,00,00,00,00,00,00,00,00
00,00,00,00,00,00,00,00,00,00,00,00,00,00,00,00,00,00,00,00
07,08
41
