00,00,00,00,00,00,00,00,00,00,00,00,00,00,00,00,00,00,00,00
00,00,00,00,11,12,12,12,12,12,12,12,12,12,12,13,00,00,00,00
00,00,00,00,14,21,21,21,22,21,21,22,23,24,23,04,00,00,00,00
00,00,00,00,14,22,23,23,24,24,23,22,24,27,24,16,00,00,00,00
00,00,00,00,14,21,21,23,25,25,24,22,22,25,23,16,00,00,00,00
00,00,00,00,14,22,24,25,24,24,24,22,21,23,22,16,00,00,00,00
00,00,00,00,14,21,23,22,21,21,23,23,23,25,22,16,00,00,00,00
00,00,00,00,14,24,25,22,22,21,22,23,25,26,23,16,00,00,00,00
00,00,00,00,14,24,26,23,22,22,23,22,24,26,23,16,00,00,00,00
00,00,00,00,14,24,25,22,23,23,24,21,23,24,22,16,00,00,00,00
00,00,00,00,14,24,23,23,23,21,23,21,25,24,22,16,00,00,00,00
00,00,00,00,03,23,23,24,23,23,23,21,23,23,22,16,00,00,00,00
00,00,00,00,17,18,18,18,18,18,18,18,18,18,18,19,00,00,00,00
00,00,00,00,00,00,00,00,00,00,00,00,00,00,00,00,00,00,00,00
00,00,00,00,00,00,00,00,00,00,00,00,00,00,00,00,00,00,00,00
04,11
299
