00,00,00,00,00,00,00,00,00,00,00,00,00,00,00,00,00,00,00,00
00,00,00,00,00,00,00,00,00,00,00,00,00,00,00,00,00,00,00,00
00,00,00,00,00,00,00,00,00,00,00,00,00,00,00,00,00,00,00,00
00,00,00,00,00,00,11,12,12,12,12,12,12,13,00,00,00,00,00,00
00,00,00,00,00,00,14,22,23,24,24,23,23,04,00,00,00,00,00,00
00,00,00,00,00,00,14,23,24,25,25,26,23,16,00,00,00,00,00,00
00,00,00,00,00,00,14,22,23,25,25,24,21,16,00,00,00,00,00,00
00,00,00,00,00,00,14,22,25,25,26,26,24,16,00,00,00,00,00,00
00,00,00,00,00,00,14,22,24,23,25,25,24,16,00,00,00,00,00,00
00,00,00,00,00,00,03,22,22,21,24,26,24,16,00,00,00,00,00,00
00,00,00,00,00,00,17,18,18,18,18,18,18,19,00,00,00,00,00,00
00,00,00,00,00,00,00,00,00,00,00,00,00,00,00,00,00,00,00,00
00,00,00,00,00,00,00,00,00,00,00,00,00,00,00,00,00,00,00,00
00,00,00,00,00,00,00,00,00,00,00,00,00,00,00,00,00,00,00,00
00,00,00,00,00,00,00,00,00,00,00,00,00,00,00,00,00,00,00,00
06,09
137
