00,00,00,00,00,00,00,00,00,00,00,00,00,00,00,00,00,00,00,00
00,00,00,00,00,00,00,00,00,00,00,00,00,00,00,00,00,00,00,00
00,00,00,00,00,11,12,12,12,12,12,12,12,12,13,00,00,00,00,00
00,00,00,00,00,14,00,00,00,00,00,00,00,00,04,00,00,00,00,00
00,00,00,00,00,14,00,00,00,00,00,00,00,00,16,00,00,00,00,00
00,00,00,00,00,14,00,00,00,00,00,00,00,00,16,00,00,00,00,00
00,00,00,00,00,14,00,00,00,00,00,00,00,00,16,00,00,00,00,00
00,00,00,00,00,14,00,00,00,00,00,00,00,00,16,00,00,00,00,00
00,00,00,00,00,14,00,00,00,00,00,00,00,00,16,00,00,00,00,00
00,00,00,00,00,14,00,00,00,00,00,00,00,00,16,00,00,00,00,00
00,00,00,00,00,03,00,00,00,00,00,00,00,00,16,00,00,00,00,00
00,00,00,00,00,17,18,18,18,18,18,18,18,18,19,00,00,00,00,00
00,00,00,00,00,00,00,00,00,00,00,00,00,00,00,00,00,00,00,00
00,00,00,00,00,00,00,00,00,00,00,00,00,00,00,00,00,00,00,00
00,00,00,00,00,00,00,00,00,00,00,00,00,00,00,00,00,00,00,00
05,10
0