00,00,00,00,00,00,00,00,00,00,00,00,00,00,00,00,00,00,00,00
00,00,00,00,00,00,00,00,00,00,00,00,00,00,00,00,00,00,00,00
00,00,00,00,00,11,12,12,12,12,12,12,12,12,13,00,00,00,00,00
00,00,00,00,00,14,21,22,22,22,22,22,22,22,04,00,00,00,00,00
00,00,00,00,00,14,22,23,22,21,23,23,21,22,16,00,00,00,00,00
00,00,00,00,00,14,22,22,22,22,23,23,22,22,16,00,00,00,00,00
00,00,00,00,00,14,23,24,24,23,23,21,21,22,16,00,00,00,00,00
00,00,00,00,00,14,23,23,24,24,24,21,21,22,16,00,00,00,00,00
00,00,00,00,00,14,22,22,23,24,23,22,24,23,16,00,00,00,00,00
00,00,00,00,00,14,21,21,22,25,24,22,24,23,16,00,00,00,00,00
00,00,00,00,00,03,21,21,21,22,24,23,22,21,16,00,00,00,00,00
00,00,00,00,00,17,18,18,18,18,18,18,18,18,19,00,00,00,00,00
00,00,00,00,00,00,00,00,00,00,00,00,00,00,00,00,00,00,00,00
00,00,00,00,00,00,00,00,00,00,00,00,00,00,00,00,00,00,00,00
00,00,00,00,00,00,00,00,00,00,00,00,00,00,00,00,00,00,00,00
05,10
155
