00,00,00,00,00,00,00,00,00,00,00,00,00,00,00,00,00,00,00,00
00,00,00,00,00,00,00,00,00,00,00,00,00,00,00,00,00,00,00,00
00,00,00,00,00,11,12,12,12,12,12,12,12,12,13,00,00,00,00,00
00,00,00,00,00,14,24,24,22,24,26,25,23,23,04,00,00,00,00,00
00,00,00,00,00,14,26,26,25,25,24,24,24,24,16,00,00,00,00,00
00,00,00,00,00,14,25,25,24,24,24,26,25,23,16,00,00,00,00,00
00,00,00,00,00,14,26,26,24,26,27,27,26,24,16,00,00,00,00,00
00,00,00,00,00,14,27,26,24,26,25,24,25,24,16,00,00,00,00,00
00,00,00,00,00,14,25,26,24,23,23,23,24,23,16,00,00,00,00,00
00,00,00,00,00,14,24,27,27,24,25,24,26,25,16,00,00,00,00,00
00,00,00,00,00,03,22,23,24,22,24,24,25,24,16,00,00,00,00,00
00,00,00,00,00,17,18,18,18,18,18,18,18,18,19,00,00,00,00,00
00,00,00,00,00,00,00,00,00,00,00,00,00,00,00,00,00,00,00,00
00,00,00,00,00,00,00,00,00,00,00,00,00,00,00,00,00,00,00,00
00,00,00,00,00,00,00,00,00,00,00,00,00,00,00,00,00,00,00,00
05,10
295
