00,00,00,00,00,00,00,00,00,00,00,00,00,00,00,00,00,00,00,00
00,00,00,00,00,00,00,00,00,00,00,00,00,00,00,00,00,00,00,00
00,00,00,00,00,00,00,00,00,00,00,00,00,00,00,00,00,00,00,00
00,00,00,00,00,00,11,12,12,12,12,12,12,13,00,00,00,00,00,00
00,00,00,00,00,00,14,21,23,22,24,22,22,04,00,00,00,00,00,00
00,00,00,00,00,00,14,22,23,21,24,23,24,16,00,00,00,00,00,00
00,00,00,00,00,00,14,22,22,22,22,21,23,16,00,00,00,00,00,00
00,00,00,00,00,00,14,21,23,23,22,24,24,16,00,00,00,00,00,00
00,00,00,00,00,00,14,21,21,21,21,22,22,16,00,00,00,00,00,00
00,00,00,00,00,00,03,22,22,22,21,21,21,16,00,00,00,00,00,00
00,00,00,00,00,00,17,18,18,18,18,18,18,19,00,00,00,00,00,00
00,00,00,00,00,00,00,00,00,00,00,00,00,00,00,00,00,00,00,00
00,00,00,00,00,00,00,00,00,00,00,00,00,00,00,00,00,00,00,00
00,00,00,00,00,00,00,00,00,00,00,00,00,00,00,00,00,00,00,00
00,00,00,00,00,00,00,00,00,00,00,00,00,00,00,00,00,00,00,00
06,09
79
