00,00,00,00,00,00,00,00,00,00,00,00,00,00,00,00,00,00,00,00
00,00,00,00,00,00,00,00,00,00,00,00,00,00,00,00,00,00,00,00
00,00,00,00,00,00,00,00,00,00,00,00,00,00,00,00,00,00,00,00
00,00,00,00,00,00,11,12,12,12,12,12,12,13,00,00,00,00,00,00
00,00,00,00,00,00,14,23,27,27,25,26,25,04,00,00,00,00,00,00
00,00,00,00,00,00,14,24,26,26,25,27,26,16,00,00,00,00,00,00
00,00,00,00,00,00,14,24,25,24,25,26,24,16,00,00,00,00,00,00
00,00,00,00,00,00,14,25,27,26,24,26,25,16,00,00,00,00,00,00
00,00,00,00,00,00,14,24,25,25,23,26,25,16,00,00,00,00,00,00
00,00,00,00,00,00,03,22,24,24,22,24,23,16,00,00,00,00,00,00
00,00,00,00,00,00,17,18,18,18,18,18,18,19,00,00,00,00,00,00
00,00,00,00,00,00,00,00,00,00,00,00,00,00,00,00,00,00,00,00
00,00,00,00,00,00,00,00,00,00,00,00,00,00,00,00,00,00,00,00
00,00,00,00,00,00,00,00,00,00,00,00,00,00,00,00,00,00,00,00
00,00,00,00,00,00,00,00,00,00,00,00,00,00,00,00,00,00,00,00
06,09
177
