00,00,00,00,00,00,00,00,00,00,00,00,00,00,00,00,00,00,00,00
00,00,00,00,00,00,00,00,00,00,00,00,00,00,00,00,00,00,00,00
00,00,00,00,00,00,00,00,00,00,00,00,00,00,00,00,00,00,00,00
00,00,00,00,00,00,11,12,12,12,12,12,12,13,00,00,00,00,00,00
00,00,00,00,00,00,14,21,22,22,23,22,22,04,00,00,00,00,00,00
00,00,00,00,00,00,14,23,25,25,25,24,24,16,00,00,00,00,00,00
00,00,00,00,00,00,14,23,25,25,26,27,24,16,00,00,00,00,00,00
00,00,00,00,00,00,14,22,24,23,25,26,23,16,00,00,00,00,00,00
00,00,00,00,00,00,14,21,24,23,24,24,23,16,00,00,00,00,00,00
00,00,00,00,00,00,03,21,23,22,21,22,22,16,00,00,00,00,00,00
00,00,00,00,00,00,17,18,18,18,18,18,18,19,00,00,00,00,00,00
00,00,00,00,00,00,00,00,00,00,00,00,00,00,00,00,00,00,00,00
00,00,00,00,00,00,00,00,00,00,00,00,00,00,00,00,00,00,00,00
00,00,00,00,00,00,00,00,00,00,00,00,00,00,00,00,00,00,00,00
00,00,00,00,00,00,00,00,00,00,00,00,00,00,00,00,00,00,00,00
06,09
123
