00,00,00,00,00,00,00,00,00,00,00,00,00,00,00,00,00,00,00,00
00,00,00,00,00,00,00,00,00,00,00,00,00,00,00,00,00,00,00,00
00,00,00,00,00,00,00,00,00,00,00,00,00,00,00,00,00,00,00,00
00,00,00,00,00,00,11,12,12,12,12,12,12,13,00,00,00,00,00,00
00,00,00,00,00,00,14,21,22,23,24,22,21,04,00,00,00,00,00,00
00,00,00,00,00,00,14,23,25,25,25,25,22,16,00,00,00,00,00,00
00,00,00,00,00,00,14,23,23,23,24,26,23,16,00,00,00,00,00,00
00,00,00,00,00,00,14,22,25,24,25,26,23,16,00,00,00,00,00,00
00,00,00,00,00,00,14,23,26,24,26,25,23,16,00,00,00,00,00,00
00,00,00,00,00,00,03,23,23,22,25,25,23,16,00,00,00,00,00,00
00,00,00,00,00,00,17,18,18,18,18,18,18,19,00,00,00,00,00,00
00,00,00,00,00,00,00,00,00,00,00,00,00,00,00,00,00,00,00,00
00,00,00,00,00,00,00,00,00,00,00,00,00,00,00,00,00,00,00,00
00,00,00,00,00,00,00,00,00,00,00,00,00,00,00,00,00,00,00,00
00,00,00,00,00,00,00,00,00,00,00,00,00,00,00,00,00,00,00,00
06,09
135
