00,00,00,00,00,00,00,00,00,00,00,00,00,00,00,00,00,00,00,00
00,00,00,00,11,12,12,12,12,12,12,12,12,12,12,13,00,00,00,00
00,00,00,00,14,21,22,21,21,22,25,25,23,23,21,04,00,00,00,00
00,00,00,00,14,23,23,21,23,25,27,26,23,23,21,16,00,00,00,00
00,00,00,00,14,22,22,21,22,25,26,25,24,22,21,16,00,00,00,00
00,00,00,00,14,21,23,24,26,27,27,25,26,23,22,16,00,00,00,00
00,00,00,00,14,21,23,24,26,24,25,27,26,23,22,16,00,00,00,00
00,00,00,00,14,23,23,23,23,25,26,24,22,21,21,16,00,00,00,00
00,00,00,00,14,23,23,25,25,25,23,23,22,22,23,16,00,00,00,00
00,00,00,00,14,23,24,24,22,22,21,23,21,23,23,16,00,00,00,00
00,00,00,00,14,21,23,23,24,24,25,25,22,23,22,16,00,00,00,00
00,00,00,00,03,21,23,23,23,21,22,22,21,21,21,16,00,00,00,00
00,00,00,00,17,18,18,18,18,18,18,18,18,18,18,19,00,00,00,00
00,00,00,00,00,00,00,00,00,00,00,00,00,00,00,00,00,00,00,00
00,00,00,00,00,00,00,00,00,00,00,00,00,00,00,00,00,00,00,00
04,11
317
