00,00,00,00,00,00,00,00,00,00,00,00,00,00,00,00,00,00,00,00
00,00,00,00,00,00,00,00,00,00,00,00,00,00,00,00,00,00,00,00
00,00,00,00,00,00,00,00,00,00,00,00,00,00,00,00,00,00,00,00
00,00,00,00,00,00,11,12,12,12,12,12,12,13,00,00,00,00,00,00
00,00,00,00,00,00,14,23,24,23,24,24,23,04,00,00,00,00,00,00
00,00,00,00,00,00,14,23,23,23,24,25,23,16,00,00,00,00,00,00
00,00,00,00,00,00,14,24,24,24,24,24,23,16,00,00,00,00,00,00
00,00,00,00,00,00,14,24,24,25,25,23,24,16,00,00,00,00,00,00
00,00,00,00,00,00,14,23,24,25,25,24,24,16,00,00,00,00,00,00
00,00,00,00,00,00,03,23,24,24,24,24,23,16,00,00,00,00,00,00
00,00,00,00,00,00,17,18,18,18,18,18,18,19,00,00,00,00,00,00
00,00,00,00,00,00,00,00,00,00,00,00,00,00,00,00,00,00,00,00
00,00,00,00,00,00,00,00,00,00,00,00,00,00,00,00,00,00,00,00
00,00,00,00,00,00,00,00,00,00,00,00,00,00,00,00,00,00,00,00
00,00,00,00,00,00,00,00,00,00,00,00,00,00,00,00,00,00,00,00
06,09
139
