00,00,00,00,00,00,00,00,00,00,00,00,00,00,00,00,00,00,00,00
00,00,00,00,00,00,00,00,00,00,00,00,00,00,00,00,00,00,00,00
00,00,00,00,00,00,00,00,00,00,00,00,00,00,00,00,00,00,00,00
00,00,00,00,00,00,11,12,12,12,12,12,12,13,00,00,00,00,00,00
00,00,00,00,00,00,14,22,23,24,25,24,24,04,00,00,00,00,00,00
00,00,00,00,00,00,14,24,25,27,27,25,24,16,00,00,00,00,00,00
00,00,00,00,00,00,14,24,26,27,27,27,25,16,00,00,00,00,00,00
00,00,00,00,00,00,14,23,26,26,27,26,25,16,00,00,00,00,00,00
00,00,00,00,00,00,14,23,24,22,24,23,22,16,00,00,00,00,00,00
00,00,00,00,00,00,03,22,23,23,23,22,21,16,00,00,00,00,00,00
00,00,00,00,00,00,17,18,18,18,18,18,18,19,00,00,00,00,00,00
00,00,00,00,00,00,00,00,00,00,00,00,00,00,00,00,00,00,00,00
00,00,00,00,00,00,00,00,00,00,00,00,00,00,00,00,00,00,00,00
00,00,00,00,00,00,00,00,00,00,00,00,00,00,00,00,00,00,00,00
00,00,00,00,00,00,00,00,00,00,00,00,00,00,00,00,00,00,00,00
06,09
157
