00,00,00,00,00,00,00,00,00,00,00,00,00,00,00,00,00,00,00,00
00,00,00,00,00,00,00,00,00,00,00,00,00,00,00,00,00,00,00,00
00,00,00,00,00,11,12,12,12,12,12,12,12,12,13,00,00,00,00,00
00,00,00,00,00,14,22,22,22,21,22,23,24,25,04,00,00,00,00,00
00,00,00,00,00,14,22,22,23,22,25,26,25,26,16,00,00,00,00,00
00,00,00,00,00,14,21,22,24,25,25,24,25,24,16,00,00,00,00,00
00,00,00,00,00,14,22,23,23,24,24,25,25,23,16,00,00,00,00,00
00,00,00,00,00,14,22,23,23,22,21,22,21,23,16,00,00,00,00,00
00,00,00,00,00,14,21,22,24,23,22,21,22,24,16,00,00,00,00,00
00,00,00,00,00,14,23,24,23,22,23,22,24,24,16,00,00,00,00,00
00,00,00,00,00,03,23,24,23,22,22,22,23,22,16,00,00,00,00,00
00,00,00,00,00,17,18,18,18,18,18,18,18,18,19,00,00,00,00,00
00,00,00,00,00,00,00,00,00,00,00,00,00,00,00,00,00,00,00,00
00,00,00,00,00,00,00,00,00,00,00,00,00,00,00,00,00,00,00,00
00,00,00,00,00,00,00,00,00,00,00,00,00,00,00,00,00,00,00,00
05,10
195
