00,00,00,00,00,00,00,00,00,00,00,00,00,00,00,00,00,00,00,00
00,00,00,00,00,00,00,00,00,00,00,00,00,00,00,00,00,00,00,00
00,00,00,00,00,00,00,00,00,00,00,00,00,00,00,00,00,00,00,00
00,00,00,00,00,00,11,12,12,12,12,12,12,13,00,00,00,00,00,00
00,00,00,00,00,00,14,21,21,21,21,21,21,04,00,00,00,00,00,00
00,00,00,00,00,00,14,21,23,24,25,24,21,16,00,00,00,00,00,00
00,00,00,00,00,00,14,21,23,25,25,23,21,16,00,00,00,00,00,00
00,00,00,00,00,00,14,21,23,25,26,22,21,16,00,00,00,00,00,00
00,00,00,00,00,00,14,21,23,22,24,22,21,16,00,00,00,00,00,00
00,00,00,00,00,00,03,21,21,21,21,21,21,16,00,00,00,00,00,00
00,00,00,00,00,00,17,18,18,18,18,18,18,19,00,00,00,00,00,00
00,00,00,00,00,00,00,00,00,00,00,00,00,00,00,00,00,00,00,00
00,00,00,00,00,00,00,00,00,00,00,00,00,00,00,00,00,00,00,00
00,00,00,00,00,00,00,00,00,00,00,00,00,00,00,00,00,00,00,00
00,00,00,00,00,00,00,00,00,00,00,00,00,00,00,00,00,00,00,00
06,09
81
