00,00,00,00,00,00,00,00,00,00,00,00,00,00,00,00,00,00,00,00
00,00,00,00,00,00,00,00,00,00,00,00,00,00,00,00,00,00,00,00
00,00,00,00,00,00,00,00,00,00,00,00,00,00,00,00,00,00,00,00
00,00,00,00,00,00,11,12,12,12,12,12,12,13,00,00,00,00,00,00
00,00,00,00,00,00,14,23,24,22,23,23,22,04,00,00,00,00,00,00
00,00,00,00,00,00,14,24,27,25,24,25,24,16,00,00,00,00,00,00
00,00,00,00,00,00,14,23,25,23,21,25,24,16,00,00,00,00,00,00
00,00,00,00,00,00,14,23,25,25,24,27,24,16,00,00,00,00,00,00
00,00,00,00,00,00,14,23,26,26,24,25,23,16,00,00,00,00,00,00
00,00,00,00,00,00,03,23,25,25,22,21,21,16,00,00,00,00,00,00
00,00,00,00,00,00,17,18,18,18,18,18,18,19,00,00,00,00,00,00
00,00,00,00,00,00,00,00,00,00,00,00,00,00,00,00,00,00,00,00
00,00,00,00,00,00,00,00,00,00,00,00,00,00,00,00,00,00,00,00
00,00,00,00,00,00,00,00,00,00,00,00,00,00,00,00,00,00,00,00
00,00,00,00,00,00,00,00,00,00,00,00,00,00,00,00,00,00,00,00
06,09
141
