00,00,00,00,00,00,00,00,00,00,00,00,00,00,00,00,00,00,00,00
00,00,00,00,00,00,00,00,00,00,00,00,00,00,00,00,00,00,00,00
00,00,00,00,00,00,00,00,00,00,00,00,00,00,00,00,00,00,00,00
00,00,00,00,00,00,11,12,12,12,12,12,12,13,00,00,00,00,00,00
00,00,00,00,00,00,14,24,24,22,21,21,21,04,00,00,00,00,00,00
00,00,00,00,00,00,14,25,26,25,22,21,21,16,00,00,00,00,00,00
00,00,00,00,00,00,14,24,23,21,22,23,22,16,00,00,00,00,00,00
00,00,00,00,00,00,14,25,26,24,23,22,21,16,00,00,00,00,00,00
00,00,00,00,00,00,14,24,25,24,24,22,21,16,00,00,00,00,00,00
00,00,00,00,00,00,03,22,22,22,23,22,21,16,00,00,00,00,00,00
00,00,00,00,00,00,17,18,18,18,18,18,18,19,00,00,00,00,00,00
00,00,00,00,00,00,00,00,00,00,00,00,00,00,00,00,00,00,00,00
00,00,00,00,00,00,00,00,00,00,00,00,00,00,00,00,00,00,00,00
00,00,00,00,00,00,00,00,00,00,00,00,00,00,00,00,00,00,00,00
00,00,00,00,00,00,00,00,00,00,00,00,00,00,00,00,00,00,00,00
06,09
103
