00,00,00,00,00,00,00,00,00,00,00,00,00,00,00,00,00,00,00,00
00,00,00,00,00,00,00,00,00,00,00,00,00,00,00,00,00,00,00,00
00,00,00,00,00,00,00,00,00,00,00,00,00,00,00,00,00,00,00,00
00,00,00,00,00,00,11,12,12,12,12,12,12,13,00,00,00,00,00,00
00,00,00,00,00,00,14,22,22,21,23,24,22,04,00,00,00,00,00,00
00,00,00,00,00,00,14,24,25,23,24,25,23,16,00,00,00,00,00,00
00,00,00,00,00,00,14,25,25,24,23,24,24,16,00,00,00,00,00,00
00,00,00,00,00,00,14,25,26,25,23,23,22,16,00,00,00,00,00,00
00,00,00,00,00,00,14,21,23,24,22,21,21,16,00,00,00,00,00,00
00,00,00,00,00,00,03,21,22,22,21,21,21,16,00,00,00,00,00,00
00,00,00,00,00,00,17,18,18,18,18,18,18,19,00,00,00,00,00,00
00,00,00,00,00,00,00,00,00,00,00,00,00,00,00,00,00,00,00,00
00,00,00,00,00,00,00,00,00,00,00,00,00,00,00,00,00,00,00,00
00,00,00,00,00,00,00,00,00,00,00,00,00,00,00,00,00,00,00,00
00,00,00,00,00,00,00,00,00,00,00,00,00,00,00,00,00,00,00,00
06,09
109
