00,00,00,00,00,00,00,00,00,00,00,00,00,00,00,00,00,00,00,00
00,00,00,00,00,00,00,00,00,00,00,00,00,00,00,00,00,00,00,00
00,00,00,00,00,11,12,12,12,12,12,12,12,12,13,00,00,00,00,00
00,00,00,00,00,14,21,22,22,21,21,21,21,21,04,00,00,00,00,00
00,00,00,00,00,14,22,23,23,23,23,21,21,21,16,00,00,00,00,00
00,00,00,00,00,14,22,24,25,25,25,22,22,21,16,00,00,00,00,00
00,00,00,00,00,14,22,24,26,26,24,23,23,21,16,00,00,00,00,00
00,00,00,00,00,14,22,23,25,25,24,23,23,22,16,00,00,00,00,00
00,00,00,00,00,14,22,24,25,24,24,23,23,22,16,00,00,00,00,00
00,00,00,00,00,14,22,24,24,23,21,22,23,22,16,00,00,00,00,00
00,00,00,00,00,03,22,22,22,22,21,21,21,21,16,00,00,00,00,00
00,00,00,00,00,17,18,18,18,18,18,18,18,18,19,00,00,00,00,00
00,00,00,00,00,00,00,00,00,00,00,00,00,00,00,00,00,00,00,00
00,00,00,00,00,00,00,00,00,00,00,00,00,00,00,00,00,00,00,00
00,00,00,00,00,00,00,00,00,00,00,00,00,00,00,00,00,00,00,00
05,10
171
