00,00,00,00,00,00,00,00,00,00,00,00,00,00,00,00,00,00,00,00
00,00,00,00,00,00,00,00,00,00,00,00,00,00,00,00,00,00,00,00
00,00,00,00,00,11,12,12,12,12,12,12,12,12,13,00,00,00,00,00
00,00,00,00,00,14,21,22,21,21,22,22,21,21,04,00,00,00,00,00
00,00,00,00,00,14,22,22,21,21,21,22,21,21,16,00,00,00,00,00
00,00,00,00,00,14,22,21,21,21,21,21,21,21,16,00,00,00,00,00
00,00,00,00,00,14,22,21,22,22,21,21,21,21,16,00,00,00,00,00
00,00,00,00,00,14,21,21,22,22,21,22,21,21,16,00,00,00,00,00
00,00,00,00,00,14,21,21,21,21,21,22,22,21,16,00,00,00,00,00
00,00,00,00,00,14,21,21,22,22,21,22,22,21,16,00,00,00,00,00
00,00,00,00,00,03,21,21,22,22,21,21,21,21,16,00,00,00,00,00
00,00,00,00,00,17,18,18,18,18,18,18,18,18,19,00,00,00,00,00
00,00,00,00,00,00,00,00,00,00,00,00,00,00,00,00,00,00,00,00
00,00,00,00,00,00,00,00,00,00,00,00,00,00,00,00,00,00,00,00
00,00,00,00,00,00,00,00,00,00,00,00,00,00,00,00,00,00,00,00
05,10
87
