00,00,00,00,00,00,00,00,00,00,00,00,00,00,00,00,00,00,00,00
00,00,00,00,00,00,00,00,00,00,00,00,00,00,00,00,00,00,00,00
00,00,00,00,00,00,00,00,00,00,00,00,00,00,00,00,00,00,00,00
00,00,00,00,00,00,00,00,00,00,00,00,00,00,00,00,00,00,00,00
00,00,00,00,00,00,00,11,12,12,12,12,13,00,00,00,00,00,00,00
00,00,00,00,00,00,00,14,22,23,23,22,04,00,00,00,00,00,00,00
00,00,00,00,00,00,00,14,24,24,23,23,16,00,00,00,00,00,00,00
00,00,00,00,00,00,00,14,24,24,23,24,16,00,00,00,00,00,00,00
00,00,00,00,00,00,00,03,23,23,22,22,16,00,00,00,00,00,00,00
00,00,00,00,00,00,00,17,18,18,18,18,19,00,00,00,00,00,00,00
00,00,00,00,00,00,00,00,00,00,00,00,00,00,00,00,00,00,00,00
00,00,00,00,00,00,00,00,00,00,00,00,00,00,00,00,00,00,00,00
00,00,00,00,00,00,00,00,00,00,00,00,00,00,00,00,00,00,00,00
00,00,00,00,00,00,00,00,00,00,00,00,00,00,00,00,00,00,00,00
00,00,00,00,00,00,00,00,00,00,00,00,00,00,00,00,00,00,00,00
07,08
51
